15 15
□  -  □  -  □  -  □  -  □  -  □  -  □  -  □  -  □  -  □  -  □  -  □  -  □  -  □  -  □
-     -     -     -     -     -     -     -     -     -     -     -     -     -     -
□  -  ●  9  ●  3  ●  6  ●  3  ●  1  ●  9  ●  1  ●  2  ●  1  ●  1  ●  7  ●  1  ●  -  □
-     2     7     -     -     -     -     -     -     -     -     -     -     6     -
□  -  ●  1  ●  -  □  -  □  -  □  -  □  -  □  -  □  -  □  -  □  -  □  -  □  -  ●  -  □
-     5     5     -     -     -     -     -     -     -     -     -     -     9     -
□  -  ●  2  ●  2  ●  6  ●  5  ●  4  ●  5  ●  8  ●  8  ●  9  ●  3  ●  -  □  -  ●  -  □
-     6     3     3     8     6     6     4     7     3     8     7     -     3     -
□  -  ●  1  ●  1  ●  4  ●  6  ●  1  ●  3  ●  5  ●  9  ●  4  ●  5  ●  -  □  -  ●  -  □
-     8     1     9     1     9     4     5     6     5     4     7     -     4     -
□  -  ●  5  ●  9  ●  5  ●  1  ●  1  ●  2  ●  7  ●  8  ●  4  ●  6  ●  -  □  -  ●  -  □
-     9     1     3     5     4     1     7     2     7     9     3     -     8     -
□  -  ●  9  ●  3  ●  6  ●  5  ●  9  ●  2  ●  4  ●  3  ●  6  ●  7  ●  -  □  -  ●  -  □
-     6     2     1     3     7     4     1     3     8     3     2     -     6     -
□  -  ●  3  ●  6  ●  4  ●  1  ●  5  ●  1  ●  8  ●  1  ●  1  ●  6  ●  -  □  -  ●  6  B
-     3     3     4     1     4     9     6     5     7     6     1     -     4     -
□  -  ●  5  ●  4  ●  3  ●  6  ●  1  ●  5  ●  9  ●  5  ●  9  ●  5  ●  -  □  -  ●  -  □
-     4     4     3     2     8     2     3     2     5     7     4     -     3     -
□  -  ●  9  ●  8  ●  3  ●  8  ●  1  ●  2  ●  7  ●  4  ●  3  ●  6  ●  -  □  -  ●  -  □
-     6     5     7     3     9     1     3     6     5     5     9     -     3     -
□  -  ●  8  ●  7  ●  4  ●  6  ●  8  ●  5  ●  7  ●  5  ●  9  ●  5  ●  -  □  -  ●  -  □
-     3     8     8     9     5     3     2     4     5     1     5     -     1     -
□  -  ●  6  ●  4  ●  1  ●  5  ●  9  ●  5  ●  6  ●  3  ●  6  ●  6  ●  -  □  -  ●  -  □
-     4     -     -     -     -     -     -     -     -     -     -     -     2     -
□  -  ●  -  □  -  □  -  □  -  □  -  □  -  □  -  □  -  □  -  □  -  □  -  □  -  ●  -  □
-     2     -     -     -     -     -     -     -     -     -     -     -     9     -
A  1  ●  5  ●  6  ●  7  ●  5  ●  1  ●  1  ●  6  ●  1  ●  9  ●  5  ●  6  ●  7  ●  -  □
-     -     -     -     -     -     -     -     -     -     -     -     -     -     -
□  -  □  -  □  -  □  -  □  -  □  -  □  -  □  -  □  -  □  -  □  -  □  -  □  -  □  -  □