13 13
□  □  □  □  □  □  □  □  □  □  □  □  □
□  ●  ●  ●  ●  □  ●  ●  □  ●  □  ●  □
□  ●  □  □  ●  □  ●  ●  ●  ●  □  ●  □
□  ●  □  ●  ●  □  □  □  ●  □  ●  ●  □
□  ●  □  □  ●  □  ●  □  ●  □  ●  ●  A
B  ●  ●  ●  ●  □  ●  □  ●  ●  ●  ●  □
□  □  ●  □  ●  □  ●  □  ●  □  □  □  □
□  ●  ●  □  ●  ●  ●  □  ●  ●  □  ●  □
□  ●  □  □  ●  □  ●  □  □  ●  □  ●  □
□  ●  ●  □  ●  □  ●  □  ●  ●  ●  ●  □
□  □  □  □  □  □  ●  □  □  □  ●  □  □
□  ●  ●  ●  ●  ●  ●  ●  ●  ●  ●  ●  □
□  □  □  □  □  □  □  □  □  □  □  □  □