15 15
□  -  □  -  □  -  □  -  □  -  □  -  □  -  □  -  □  -  □  -  □  -  □  -  □  -  □  -  □
-     -     -     -     -     -     -     -     -     -     -     -     -     -     -
□  -  ●  1  ●  1  ●  9  ●  9  ●  1  ●  1  ●  9  ●  9  ●  1  ●  1  ●  9  ●  9  ●  -  □
-     1     9     1     9     1     9     1     9     1     9     1     9     9     -
□  -  ●  9  ●  9  ●  9  ●  9  ●  9  ●  9  ●  9  ●  9  ●  9  ●  9  ●  9  ●  9  ●  -  □
-     1     9     1     9     1     9     1     9     1     9     1     9     9     -
□  -  ●  9  ●  9  ●  9  ●  9  ●  9  ●  9  ●  9  ●  9  ●  9  ●  9  ●  9  ●  9  ●  -  □
-     1     9     1     9     1     9     1     9     1     9     1     9     9     -
□  -  ●  9  ●  9  ●  9  ●  9  ●  9  ●  9  ●  9  ●  9  ●  9  ●  9  ●  9  ●  9  ●  -  □
-     1     9     1     9     1     9     1     9     1     9     1     9     9     -
□  -  ●  9  ●  9  ●  9  ●  9  ●  9  ●  9  ●  9  ●  9  ●  9  ●  9  ●  9  ●  9  ●  1  B
-     1     9     1     9     1     9     1     9     1     9     1     9     1     -
□  -  ●  9  ●  9  ●  9  ●  9  ●  9  ●  9  ●  9  ●  9  ●  9  ●  9  ●  9  ●  9  ●  -  □
-     1     9     1     9     1     9     1     9     1     9     1     9     1     -
□  -  ●  9  ●  9  ●  9  ●  9  ●  9  ●  9  ●  9  ●  9  ●  9  ●  9  ●  9  ●  9  ●  -  □
-     1     9     1     9     1     9     1     9     1     9     1     9     1     -
□  -  ●  9  ●  9  ●  9  ●  9  ●  9  ●  9  ●  9  ●  9  ●  9  ●  9  ●  9  ●  9  ●  -  □
-     1     9     1     9     1     9     1     9     1     9     1     9     1     -
□  -  ●  9  ●  9  ●  9  ●  9  ●  9  ●  9  ●  9  ●  9  ●  9  ●  9  ●  9  ●  9  ●  -  □
-     1     9     1     9     1     9     1     9     1     9     1     9     1     -
□  -  ●  9  ●  9  ●  9  ●  9  ●  9  ●  9  ●  9  ●  9  ●  9  ●  9  ●  9  ●  9  ●  -  □
-     1     9     1     9     1     9     1     9     1     9     1     9     1     -
A  1  ●  9  ●  9  ●  9  ●  9  ●  9  ●  9  ●  9  ●  9  ●  9  ●  9  ●  9  ●  9  ●  -  □
-     9     9     1     9     1     9     1     9     1     9     1     9     1     -
□  -  ●  9  ●  9  ●  9  ●  9  ●  9  ●  9  ●  9  ●  9  ●  9  ●  9  ●  9  ●  9  ●  -  □
-     9     9     1     9     1     9     1     9     1     9     1     9     1     -
□  -  ●  9  ●  9  ●  1  ●  1  ●  9  ●  9  ●  1  ●  1  ●  9  ●  9  ●  1  ●  1  ●  -  □
-     -     -     -     -     -     -     -     -     -     -     -     -     -     -
□  -  □  -  □  -  □  -  □  -  □  -  □  -  □  -  □  -  □  -  □  -  □  -  □  -  □  -  □