15 15
□  □  □  □  □  □  □  □  □  □  □  □  □  □  □
□  □  □  □  □  □  □  ●  □  □  □  □  □  □  □
□  □  □  □  □  □  □  ●  □  □  □  □  □  □  □
□  □  □  □  □  □  □  ●  □  □  □  □  □  □  □
□  □  □  □  □  □  □  ●  □  □  □  □  □  □  □
□  □  □  □  □  □  □  ●  □  □  □  □  □  □  □
□  □  □  □  □  □  □  ●  □  □  □  □  □  □  □
A  ●  ●  ●  ●  ●  ●  ●  ●  ●  ●  ●  ●  ●  B
□  □  □  □  □  □  □  ●  □  □  □  □  □  □  □
□  □  □  □  □  □  □  ●  □  □  □  □  □  □  □
□  □  □  □  □  □  □  ●  □  □  □  □  □  □  □
□  □  □  □  □  □  □  ●  □  □  □  □  □  □  □
□  □  □  □  □  □  □  ●  □  □  □  □  □  □  □
□  □  □  □  □  □  □  ●  □  □  □  □  □  □  □
□  □  □  □  □  □  □  □  □  □  □  □  □  □  □