50 50
□  □  □  □  □  □  □  □  □  □  □  □  □  □  □  □  □  □  □  □  □  □  □  □  □  □  □  □  □  □  □  □  □  □  □  □  □  □  □  □  □  □  □  □  □  □  □  □  □  □
□  ●  □  ●  ●  ●  ●  ●  ●  ●  □  □  □  □  □  □  ●  □  ●  ●  □  □  □  □  □  □  □  □  ●  ●  □  □  ●  ●  ●  ●  □  □  □  ●  □  ●  □  ●  ●  □  □  □  □  □
□  ●  □  □  □  ●  □  □  □  ●  □  ●  ●  ●  □  □  ●  □  ●  ●  ●  ●  □  ●  □  □  □  □  ●  □  □  □  ●  □  □  □  ●  □  □  ●  □  ●  □  ●  ●  □  ●  ●  ●  □
□  ●  □  □  ●  ●  ●  ●  ●  □  □  ●  □  □  ●  □  ●  □  ●  □  □  ●  ●  ●  □  ●  □  ●  ●  □  □  □  ●  ●  ●  ●  ●  □  □  ●  □  ●  □  ●  □  □  □  □  ●  □
□  ●  □  □  ●  □  □  □  ●  □  ●  ●  ●  ●  ●  ●  ●  □  ●  ●  □  □  □  ●  ●  ●  □  ●  □  □  □  □  ●  □  □  □  ●  ●  ●  ●  □  ●  ●  ●  □  □  □  □  ●  □
□  ●  ●  ●  ●  □  ●  □  ●  □  □  □  □  □  ●  □  □  □  ●  □  ●  □  □  □  □  ●  □  ●  ●  □  □  □  □  □  □  □  ●  □  ●  □  □  ●  □  □  □  □  ●  ●  ●  □
□  ●  □  □  □  □  ●  □  ●  ●  ●  ●  ●  ●  ●  ●  ●  ●  ●  □  ●  □  □  ●  ●  ●  □  □  ●  ●  ●  ●  ●  ●  ●  ●  ●  □  ●  □  □  ●  □  □  ●  □  ●  □  □  □
□  □  ●  ●  □  □  ●  □  ●  □  □  □  □  □  □  ●  □  ●  □  □  ●  ●  ●  □  □  ●  □  □  ●  □  □  ●  ●  □  □  □  □  □  ●  □  □  ●  ●  ●  ●  □  ●  ●  □  □
□  ●  ●  □  ●  ●  ●  ●  ●  □  ●  ●  ●  □  □  ●  □  ●  ●  □  ●  □  ●  ●  ●  ●  □  □  ●  □  ●  □  □  □  ●  □  □  ●  ●  ●  □  ●  □  □  □  □  ●  □  □  □
□  ●  □  ●  ●  □  □  □  □  □  ●  ●  ●  ●  □  □  □  □  ●  □  □  □  ●  □  □  □  □  □  ●  □  ●  □  ●  ●  ●  ●  □  ●  □  ●  ●  ●  ●  ●  ●  ●  ●  ●  □  □
□  ●  □  ●  □  ●  ●  □  □  □  ●  ●  ●  ●  ●  ●  □  □  ●  ●  □  □  ●  ●  ●  ●  ●  □  ●  □  ●  □  ●  □  □  ●  □  ●  □  □  ●  □  □  ●  □  ●  □  ●  □  □
□  ●  □  ●  □  □  ●  ●  □  □  ●  □  □  □  □  ●  ●  □  □  ●  ●  □  ●  □  □  □  ●  ●  ●  □  ●  □  ●  □  □  ●  □  ●  □  □  □  ●  □  ●  □  ●  □  ●  ●  □
□  ●  ●  ●  ●  ●  ●  ●  □  □  ●  ●  ●  □  □  □  ●  □  □  □  ●  □  ●  □  □  ●  ●  ●  □  □  ●  ●  ●  ●  ●  ●  ●  ●  □  ●  ●  ●  ●  ●  □  ●  □  □  ●  □
□  ●  □  ●  □  ●  □  □  □  ●  ●  □  ●  □  ●  □  ●  ●  □  □  ●  ●  ●  □  □  ●  □  □  □  □  □  □  □  □  ●  □  □  ●  □  ●  □  □  □  ●  □  ●  □  □  ●  □
□  ●  □  ●  □  ●  ●  □  □  □  ●  □  ●  ●  ●  □  □  ●  ●  □  □  □  ●  □  □  ●  □  ●  ●  ●  ●  ●  □  □  ●  □  ●  ●  □  ●  □  □  ●  ●  □  ●  □  □  ●  □
□  ●  □  □  □  □  ●  □  ●  □  ●  ●  □  ●  □  □  □  □  ●  □  □  ●  ●  ●  □  ●  □  ●  ●  □  ●  ●  ●  ●  ●  □  □  ●  ●  □  □  □  ●  □  □  ●  □  □  ●  □
A  ●  ●  ●  ●  □  ●  □  ●  □  □  ●  □  ●  □  □  □  ●  ●  □  □  □  ●  □  □  ●  □  ●  □  □  □  ●  □  □  □  □  □  ●  □  □  ●  ●  ●  □  □  ●  □  □  ●  □
□  ●  □  □  ●  ●  ●  □  ●  □  □  ●  □  ●  ●  ●  □  □  ●  ●  ●  ●  ●  ●  ●  ●  ●  ●  ●  □  ●  ●  □  ●  ●  ●  □  ●  □  □  ●  □  □  □  ●  ●  ●  □  ●  □
□  ●  □  □  ●  □  □  □  ●  □  □  ●  □  □  □  ●  □  □  ●  □  ●  □  ●  □  ●  □  □  ●  ●  ●  ●  ●  □  ●  □  ●  ●  ●  □  □  ●  □  ●  ●  ●  ●  ●  □  □  □
□  ●  □  ●  ●  □  □  □  ●  □  □  ●  □  ●  □  ●  ●  ●  ●  □  □  □  ●  □  □  □  □  □  □  □  □  □  □  ●  ●  □  □  ●  ●  ●  ●  □  □  ●  ●  ●  ●  □  ●  □
□  ●  □  ●  □  □  □  □  ●  □  □  ●  ●  ●  □  ●  □  □  □  □  □  ●  ●  □  ●  ●  ●  ●  □  ●  □  □  □  □  ●  □  □  ●  □  □  ●  □  □  □  □  □  □  □  ●  □
□  ●  □  ●  ●  ●  ●  □  ●  □  □  □  □  ●  □  ●  □  □  □  ●  ●  ●  □  □  ●  □  □  ●  ●  ●  ●  ●  ●  ●  □  □  □  ●  □  □  ●  ●  ●  ●  ●  ●  ●  ●  ●  □
□  ●  □  □  □  □  ●  □  ●  □  □  □  □  ●  □  □  □  ●  □  ●  ●  ●  □  □  ●  □  □  ●  ●  ●  ●  ●  ●  ●  □  □  □  ●  □  □  □  ●  ●  □  □  □  □  ●  □  □
□  ●  ●  ●  □  □  ●  ●  ●  ●  ●  ●  □  ●  □  □  □  ●  □  ●  ●  ●  □  □  ●  ●  □  ●  ●  ●  ●  ●  ●  ●  ●  ●  ●  ●  ●  ●  □  □  □  □  ●  □  □  ●  □  □
□  □  □  ●  ●  □  □  □  ●  □  □  □  ●  ●  □  ●  ●  ●  ●  ●  ●  ●  □  □  □  □  □  □  □  ●  □  □  □  □  □  □  □  ●  □  □  □  □  □  □  ●  ●  ●  ●  ●  □
□  ●  ●  □  ●  □  □  ●  ●  ●  □  □  ●  □  ●  ●  □  □  □  ●  ●  ●  ●  ●  ●  □  ●  ●  □  ●  □  ●  □  □  □  □  □  ●  ●  ●  ●  ●  ●  ●  ●  □  □  ●  □  □
□  ●  ●  ●  ●  □  □  ●  □  ●  ●  ●  □  □  ●  ●  ●  ●  □  □  □  □  □  □  ●  □  □  ●  ●  ●  ●  ●  ●  □  ●  □  ●  □  □  □  □  ●  □  ●  □  □  □  ●  ●  □
□  □  □  □  ●  □  □  ●  □  ●  □  ●  □  □  ●  ●  ●  □  □  □  ●  □  □  □  ●  □  □  □  □  □  □  □  ●  □  ●  □  ●  □  ●  □  □  ●  □  ●  □  ●  ●  ●  □  □
□  □  ●  □  ●  □  ●  ●  □  □  □  ●  ●  □  □  ●  ●  □  ●  ●  ●  ●  ●  ●  ●  ●  ●  ●  ●  ●  ●  ●  ●  ●  ●  ●  ●  □  ●  □  □  ●  □  □  □  □  □  ●  ●  □
□  □  ●  □  ●  □  ●  □  □  □  □  □  □  □  □  ●  ●  □  ●  □  □  ●  □  □  □  □  ●  □  □  □  □  ●  □  □  ●  □  □  □  ●  □  □  ●  ●  ●  ●  ●  □  ●  □  □
□  □  ●  □  ●  □  ●  ●  ●  ●  □  ●  ●  ●  □  □  ●  □  ●  □  □  ●  □  □  □  □  ●  ●  ●  □  □  ●  □  □  ●  □  □  □  ●  □  ●  ●  □  ●  □  ●  □  ●  □  □
□  □  ●  □  ●  □  ●  □  □  ●  □  ●  □  ●  □  ●  ●  ●  ●  □  □  ●  □  ●  ●  ●  ●  □  ●  □  ●  ●  ●  □  ●  ●  ●  □  ●  □  □  ●  □  ●  □  ●  □  ●  □  □
□  □  ●  □  ●  □  ●  □  □  ●  □  ●  ●  ●  □  □  □  ●  □  □  □  □  □  ●  □  □  □  □  ●  □  ●  ●  □  □  ●  □  ●  □  ●  □  □  □  □  □  □  ●  ●  ●  ●  □
□  □  ●  □  ●  ●  ●  ●  ●  ●  □  □  □  ●  □  □  □  ●  □  □  □  ●  ●  ●  □  □  □  ●  ●  □  □  □  □  □  □  □  ●  □  ●  ●  ●  ●  □  ●  ●  □  ●  □  ●  □
□  □  ●  □  □  □  □  ●  □  ●  ●  ●  ●  ●  ●  ●  ●  ●  ●  □  □  □  □  ●  □  □  □  ●  □  □  ●  ●  ●  □  ●  ●  ●  □  ●  □  □  ●  □  ●  ●  ●  ●  ●  ●  □
□  □  ●  □  ●  □  □  □  □  ●  □  ●  □  □  □  ●  □  □  ●  □  ●  ●  □  □  □  □  □  ●  ●  ●  ●  □  ●  □  ●  □  ●  ●  ●  □  □  ●  □  ●  □  □  ●  □  ●  □
□  □  ●  ●  ●  ●  ●  □  □  ●  □  ●  ●  □  □  ●  ●  □  ●  □  □  ●  □  □  ●  ●  ●  □  □  □  □  □  ●  ●  ●  □  ●  □  ●  □  □  ●  □  □  ●  □  □  □  ●  □
□  ●  ●  □  □  □  □  □  □  □  □  □  ●  □  □  ●  ●  □  ●  □  ●  ●  □  □  ●  ●  ●  ●  ●  ●  ●  □  □  □  ●  □  ●  □  ●  □  ●  ●  ●  ●  ●  ●  ●  ●  ●  □
□  □  ●  □  ●  ●  □  □  ●  ●  ●  ●  ●  □  ●  ●  □  □  ●  ●  ●  □  □  □  ●  ●  ●  □  □  □  ●  □  □  □  ●  □  ●  □  ●  □  □  □  □  ●  □  □  □  □  ●  □
□  □  ●  □  □  ●  □  □  ●  □  ●  □  ●  ●  □  □  □  □  ●  □  ●  □  □  □  □  ●  □  □  ●  □  ●  □  □  □  ●  □  ●  □  ●  ●  ●  ●  ●  ●  □  ●  ●  ●  ●  □
□  ●  ●  ●  ●  ●  ●  □  ●  ●  ●  ●  ●  ●  ●  ●  ●  □  ●  □  ●  ●  ●  □  □  ●  □  □  ●  ●  ●  ●  □  ●  ●  □  ●  □  □  □  ●  □  □  ●  □  ●  ●  □  ●  □
□  ●  □  □  ●  □  ●  □  ●  □  □  □  □  ●  □  □  ●  ●  ●  □  □  □  ●  □  □  ●  □  □  ●  □  □  ●  ●  ●  □  □  ●  □  □  ●  ●  ●  □  ●  □  ●  □  □  ●  □
□  □  □  □  □  □  ●  ●  ●  ●  ●  □  □  □  □  □  □  □  ●  ●  ●  □  ●  □  □  ●  □  ●  □  □  ●  ●  ●  □  □  □  □  □  □  □  ●  □  ●  ●  □  ●  □  □  ●  □
□  ●  ●  ●  □  □  ●  □  □  □  ●  □  ●  □  □  ●  ●  ●  ●  □  ●  ●  ●  ●  ●  ●  ●  ●  □  □  □  □  ●  ●  ●  □  □  □  □  □  □  □  □  □  □  ●  □  □  ●  □
□  ●  □  ●  ●  □  ●  □  ●  ●  ●  □  ●  □  □  ●  □  □  ●  □  □  □  □  □  □  ●  □  ●  ●  □  □  □  □  □  □  ●  ●  ●  ●  ●  ●  ●  ●  ●  ●  ●  ●  □  ●  □
□  □  □  ●  □  □  ●  □  □  □  ●  □  ●  □  ●  ●  □  □  ●  □  □  □  □  ●  □  ●  □  □  ●  ●  ●  ●  □  □  □  □  □  □  □  □  □  □  ●  □  □  □  ●  □  ●  □
□  □  ●  ●  ●  ●  ●  ●  □  □  ●  □  ●  ●  ●  □  □  □  ●  ●  ●  ●  □  ●  □  ●  □  □  □  □  □  □  ●  ●  ●  ●  ●  □  ●  ●  □  □  ●  ●  ●  □  ●  □  ●  □
□  □  ●  □  □  □  □  □  □  ●  ●  □  ●  ●  □  □  ●  □  □  □  □  ●  ●  ●  □  ●  ●  ●  □  □  ●  □  ●  □  □  □  ●  □  □  ●  □  □  □  □  ●  □  ●  ●  ●  □
□  ●  ●  □  ●  ●  ●  ●  ●  ●  ●  ●  ●  ●  ●  ●  ●  □  □  □  □  □  ●  ●  □  □  □  ●  ●  ●  ●  □  □  □  ●  ●  ●  ●  ●  ●  ●  ●  ●  ●  ●  □  ●  □  ●  □
□  □  □  □  □  □  □  □  □  □  □  □  □  □  □  □  □  □  □  □  □  □  □  □  □  □  □  □  □  □  □  □  □  □  □  □  □  □  □  □  □  □  □  □  □  □  B  □  □  □