15 15
□  □  □  □  □  □  □  □  □  □  □  □  □  □  □
□  ●  ●  ●  ●  ●  ●  ●  ●  ●  ●  ●  ●  ●  □
□  ●  ●  ●  ●  ●  ●  ●  ●  ●  ●  ●  ●  ●  □
□  ●  ●  ●  ●  ●  ●  ●  ●  ●  ●  ●  ●  ●  □
□  ●  ●  ●  ●  ●  ●  ●  ●  ●  ●  ●  ●  ●  □
□  ●  ●  ●  ●  ●  ●  ●  ●  ●  ●  ●  ●  ●  B
□  ●  ●  ●  ●  ●  ●  ●  ●  ●  ●  ●  ●  ●  □
□  ●  ●  ●  ●  ●  ●  ●  ●  ●  ●  ●  ●  ●  □
□  ●  ●  ●  ●  ●  ●  ●  ●  ●  ●  ●  ●  ●  □
□  ●  ●  ●  ●  ●  ●  ●  ●  ●  ●  ●  ●  ●  □
□  ●  ●  ●  ●  ●  ●  ●  ●  ●  ●  ●  ●  ●  □
A  ●  ●  ●  ●  ●  ●  ●  ●  ●  ●  ●  ●  ●  □
□  ●  ●  ●  ●  ●  ●  ●  ●  ●  ●  ●  ●  ●  □
□  ●  ●  ●  ●  ●  ●  ●  ●  ●  ●  ●  ●  ●  □
□  □  □  □  □  □  □  □  □  □  □  □  □  □  □