15 15
□  -  □  -  □  -  □  -  □  -  □  -  □  -  □  -  □  -  □  -  □  -  □  -  □  -  □  -  □
-     -     -     -     -     -     -     -     -     -     -     -     -     -     -
□  -  □  -  □  -  □  -  □  -  □  -  □  -  □  -  □  -  □  -  □  -  □  -  □  -  □  -  □
-     -     -     -     -     -     -     -     -     -     -     -     -     -     -
□  -  □  -  □  -  □  -  □  -  □  -  □  -  □  -  □  -  □  -  □  -  □  -  □  -  □  -  □
-     -     -     -     -     -     -     -     -     -     -     -     -     -     -
□  -  □  -  □  -  □  -  □  -  □  -  □  -  □  -  □  -  □  -  □  -  □  -  □  -  □  -  □
-     -     -     -     -     -     -     -     -     -     -     -     -     -     -
□  -  □  -  □  -  □  -  □  -  □  -  □  -  □  -  □  -  □  -  □  -  □  -  □  -  □  -  □
-     -     -     -     -     -     -     -     -     -     -     -     -     -     -
□  -  □  -  □  -  □  -  □  -  □  -  □  -  □  -  □  -  □  -  □  -  □  -  □  -  □  -  □
-     -     -     -     -     -     -     -     -     -     -     -     -     -     -
□  -  □  -  □  -  □  -  □  -  □  -  □  -  □  -  □  -  □  -  □  -  □  -  □  -  □  -  □
-     -     -     -     -     -     -     -     -     -     -     -     -     -     -
A  1  ●  3  ●  6  ●  4  ●  1  ●  5  ●  1  ●  8  ●  1  ●  1  ●  6  ●  1  ●  7  ●  6  B
-     -     -     -     -     -     -     -     -     -     -     -     -     -     -
□  -  □  -  □  -  □  -  □  -  □  -  □  -  □  -  □  -  □  -  □  -  □  -  □  -  □  -  □
-     -     -     -     -     -     -     -     -     -     -     -     -     -     -
□  -  □  -  □  -  □  -  □  -  □  -  □  -  □  -  □  -  □  -  □  -  □  -  □  -  □  -  □
-     -     -     -     -     -     -     -     -     -     -     -     -     -     -
□  -  □  -  □  -  □  -  □  -  □  -  □  -  □  -  □  -  □  -  □  -  □  -  □  -  □  -  □
-     -     -     -     -     -     -     -     -     -     -     -     -     -     -
□  -  □  -  □  -  □  -  □  -  □  -  □  -  □  -  □  -  □  -  □  -  □  -  □  -  □  -  □
-     -     -     -     -     -     -     -     -     -     -     -     -     -     -
□  -  □  -  □  -  □  -  □  -  □  -  □  -  □  -  □  -  □  -  □  -  □  -  □  -  □  -  □
-     -     -     -     -     -     -     -     -     -     -     -     -     -     -
□  -  □  -  □  -  □  -  □  -  □  -  □  -  □  -  □  -  □  -  □  -  □  -  □  -  □  -  □
-     -     -     -     -     -     -     -     -     -     -     -     -     -     -
□  -  □  -  □  -  □  -  □  -  □  -  □  -  □  -  □  -  □  -  □  -  □  -  □  -  □  -  □